{
::::::::::########:::::::
:         # .... #      :
:         #      #      :
###########H     ########
#.       V       D      #
# P   @      @@  D      F
#.               D      #
###########H     ########
:         #      #      :
:         # .... #      :
::::::::::########:::::::
}
