{
GGGGGGGGGGGGGGGGGGGGGGGGGGGGGGGGGGGGG
G###################################G
G#P                          BE ...#G
~##D####################### ########G
~#BB@A@ @@@    @@  @@@#GG#A  AA@@AA#G
~@  @@@E  @ @   E    @N~~#@    @@AA#G
~#@E    @   @ @@@@@  @#~~#@       @#~
~N@@@@@@@@@   @@@@@@  @~~#@@....@@@#~
~#NN#NN#NN#@@#NN#NN#BB#~~##N#####N##~
~~~~~~~~~~~~~~~~~~~N  N~~~~~~~~~~~~~~
~~~~~~~~~~~~~~~~~~~NFFN~~~~~~~~~~~~~~
~~~~~~~~~~~~~~~~~~~#NN#~~~~~~~~~~~~~~
~~~~~~~~~~~~~~~~~~~~~~~~~~~~~~~~~~~~~
}
