{
::#####:::::::::::
: #...#          :
: #   #          :
#### #############
#       #        #
# P     D      F #
#       #        #
#### #############
: #   #          :
: #...#          :
::#####:::::::::::
}
